+++++++++++++++++++
+0A    +++        +
+ A            ++++
+ A    + +        +
+              ++A+
+++++         +++a+
+++++++++++++++++++