+++++++++++++++++++
+0              Aa+
+              ++++
+                 +
+              ++ +
+               + +
+++++++++++++++++++
