+++++++++++++++++++
+0              A +
+              ++++
+                 +
+              ++ +
+               +a+
+++++++++++++++++++
